111111111111
100000000001
100000000001
1000000E0001
100000000001
10000P0C0001
100000000001
100000000001
100000000001
111111111111