111111111111111111
1E00000000C00001C1
111C0011100E110101
1C00111C0010000001
10P00100011100C001
100111110C001011E1
100C00E00110C00001
111111111111111111